%%%%%%%%%%%%
%%%%%%%...%%
%%%%%%%...%%
%%%%%%%...%%
%%%%%%%%%%%%
%%%%%%%%%%%%
%%%%%%%...%%
%%%%%%%...%%
%%%%%%%%%%%%
#
%%%%%%%%%%%%
%%%%%%%%%%%%
%%%%%%%%%%%%
%%%P%%%%%%.%
%%%%%%%%%%.%
%%%%%%%%%%.%
%%%%%%%%%%%%
%%%%%%%%%%%%
%%%%%%%%%%%%
#
%%%%%%%%%%%%
%%%%%%%...%%
%%%%%%%...%%
%%%%%%%...%%
%%%%%%%%%%%%
%%%%%%%%%%%%
%%%%%%%...%%
%%%%%%%...%%
%%%%%%%%%%%%
#
