%%%%%%%%%%%%%%
%%%%%%%%%...%%
%%%%%%%%%...%%
%%%%%%%%%...%%
%%%%%%%%%%%%%%
%%%%%%%%%%%%%%
%%%%%%%%%%%%%%
%%%%%%%%%...%%
%%%%%%%%%...%%
%%%%%%%%%...%%
%%%%%%%%%%%%%%
#
%%%%%%%%%%%%%%
%%%%%%%%%%%%%%
%%%%%%%%%%%%%%
%%%P%%%%%%%%%%
%%%%%%%%%%%%.%
%%%%%%%%%%%%.%
%%%%%%%%%%%%.%
%%%%%%%%%%%%%%
%%%%%%%%%%%%%%
%%%%%%%%%%%%%%
%%%%%%%%%%%%%%
#
%%%%%%%%%%%%%%
%%%%%%%%%...%%
%%%%%%%%%...%%
%%%%%%%%%...%%
%%%%%%%%%%%%%%
%%%%%%%%%%%%%%
%%%%%%%%%%%%%%
%%%%%%%%%...%%
%%%%%%%%%...%%
%%%%%%%%%...%%
%%%%%%%%%%%%%%
#
