%%%%%%%%%%%%%%%%%%%%%%%%%%%%%%%%%%%%%
%%%%%%%%%%%%%%%%%%%%%%%%%%%%%%%%%%%%%
%%%%%%%%%%%%%%%%%%%%%%%%% %%%   %%%%%
%%%%%% %%%%%%%%%%%%%%%%%%%%%%   %%%%%
%%%%%% %% %%%%%%%%%%%%%%%%%%%   %%%%%
%%%%%% %% % % %%  %%%%%%%%%%%   %%%%%
%%%%%% %%%%%%%%%%%%%%%%%%%%%%   %%%%%
%%%%%%%%%%%%%%%%%%%%%%%%%%%%%   %%%%%
%%%%%%%%%%%%%%%%%%%%% %%%%%%%   %%%%%
%%%%%%%%%%%%%%%%%%%%%%%%%%%%%   %%%%%
%%%%%  %%%%%%%%%%%%%% %%%%%%%%%%%%%%%
%%%%%%%%%%%%%%%%%%%%%%%%%%%%%%%%%%%%%
%%%%%%%%%%%%%%%%%%%%%%%%%%%%%%%%%%%%%
%%%%%%%%%%%%%%%%%%%%%%%%%%%%%%%%%%%%%
%%%%%  %%%%%%%%%%%%%%%%%%%%%%%%%%%%%%
%%%%%  %%%%%%%%%%%%%%%%%%%%%%   %%%%%
%%%%% %%%%%%%%%%%%%%%%%%%%%%%   %%%%%
%%%%%%%%%%%%% %%  %%%%%%%%%%%   %%%%%
%%%%%%%%%%% % %%  %%%%%%%%%%%   %%%%%
%%%%%%%%%%%%%%%%%%%%%%%%%%%%%   %%%%%
%%%%%%%%%%%%%%%%%%%%%%%%%%%%%   %%%%%
%%%%%%%%%%%%%%%%%%%%%%%%%%%%%%%%%%%%%
%%%%%  %% % % %% %%%%%%%%%%%%%%%%%%%%
%%%%%  %% % % %% %%%%%%%%%%%%%%%%%%%%
%%%%%  %% % % %% %%%%%%%%.%%%%%%%%%%%
%%%%%  %% % % %% %%%%%%%%%%%%%%%%%%%%
%%%%%%%%%%%%%%%%%%%%%%%%%%%%%%%%%%%%%
%%%%%%%%%%%%%%%%%%%%%%%%%%%%%%%%%%%%%
#
%%%%%%%%%%%%%%%%%%%%%%%%%%%%%%%%%%%%%
%%%%%%%%%%%%%%%%%%%%%%%%%%%%%%%%%%%%%
%%%%%%%%%%%%%%%%%%%%%%%%           %%
%%%%      %%%%%%%%%%%%%%%          %%
%%%%P      %%%%%%%%%%%%%%          %%
%%%%       %%%%%%%%  %%%%%         %%
%%%%      %%%%%%%%%   %%%%         %%
%%%%%%%%%%%%%%%%%%%%  %%%%%        %%
%%%%%%%%%%%%%%%%%%%%   %%%%        %%
%%%%%%%%%%%%%%%%%%%%   %%%%%       %%
%%   %%%%%%%%%%%%%%%    %%%%%%%%%%%%%
%%  %%%%%%%%%%%%%%%%%%  %%%%%%%%%%%%%
%%  %%%%%%%%%%%%%%%%%%  %%%%%%%%%%%%%
%%  %%%%%%%%%%%%%%%%%% %%%%%%%%%%%%%%
%%       %%%%%%%%%%%%% %%%%%%%%%%%%%%
%%      %%%%%%%%%%%%%% %%%%        %%
%%     %%%%%%%%%%%%%%% %%%%        %%
%%    %%%%%            %%%         %%
%%   %%%%%             %%%         %%
%%  %%%%%%%%%%%%%%%%%% %%%         %%
%%  %%%%%%%%%%%%%%%%%% %%%         %%
%%  %%%%%%%%%%%%%%%%%% %%%%%%%%%   %%
%%                 %%% %%%%%%%%%   %%
%%                 %%% %%%%%%%%%   %%
%%                 %%%  ...  %%%   %%
%%                 %%%%%%%%%%%%%   %%
%%%%%%%%%%%%%%%%%%%%%%%%%%%%%%%%%%%%%
%%%%%%%%%%%%%%%%%%%%%%%%%%%%%%%%%%%%%
#
%%%%%%%%%%%%%%%%%%%%%%%%%%%%%%%%%%%%%
%%%%%%%%%%%%%%%%%%%%%%%%%%%%%%%%%%%%%
%%%%%%%%%%%%%%%%%%%%%%%%%%%%%%%%%%%%%
%%%%%%%%%%%%%%%%%%%%%%%%%%%%%%%%%%%%%
%%%%%%%%%%%%%%%%%%%%%%%%%     %    %%
%%%%%%%%%%%%%%%%%%%%%%%%%%    %    %%
%%%%%%%%%%%%%%%%%%%%%%%%%%    %    %%
%%%%%%%%%%%%%%%%%%%%% %%%%%   %    %%
%%%%%%%%%%%%%%%%%%%%%  %%%%%%%%%%%%%%
%%%%%%%%%%%%%%%%%%%%%  %%%%%%%%%%%%%%
%%%%%%%%%%%%%%%%%%%%%%  %%%%%%%%%%%%%
%%%%%%%%%%%%%%%%%%%%%%  %%%%%%%%%%%%%
%%% %%%%%%%%%%%%%%%%%%  %%%%%%%%%%%%%
%%% %%%%%%%%%%%%%%%%%%  %%%%%%%%%%%%%
%%% %%%%%%%%%%%%%%%%%% %%%%%%%%%%%%%%
%%%  %%%%%%%%%%%%%%%%% %%%%%%%%%%%%%%
%%%   %%%%%%%%%%%%%%%% %%%%%%%%%%%%%%
%%%  %%%%%%%%%%%%%%%%% %%%    %    %%
%%% %%%%%%%%%%%%%%%%%% %%%    %    %%
%%% %%%%%%%%%%%%%%%%%% %%%%%%%%    %%
%%% %%%%%%%%%%%%%%%%%% %%%%%%%%%   %%
%%% %%%%%%%%%%%%%%%%%% %%%%%%%%%   %%
%%% %%%%%%%%%%%%%%%%%% %%%%%%%%%   %%
%%%  %%%%%%%%%%%%%%%%%%%%%%%%%%%   %%
%%%%%%%%%%%%%%%%%%%%%%%%%%%%%%%%%%%%%
%%%%%%%%%%%%%%%%%%%%%%%%%%%%%%%%%%%%%
%%%%%%%%%%%%%%%%%%%%%%%%%%%%%%%%%%%%%
%%%%%%%%%%%%%%%%%%%%%%%%%%%%%%%%%%%%%
#
