%%%%%%%%%%%%%%%%%%%%%%%
%%%%%%%%%%%%%%%%.%%%%%%
%%%%%%%%%%%%%%.....%%%%
%%%%%%%%%%%%%%.....%%%%
%%%%%%%%%%%%%.......%%%
%%%%%%%%%%%%%.......%%%
%%%%%%%%%%%%%%%%%%%%%%%
%%%%%%%%%%%%%%%%%%%%%%%
%%%%%%%%%%%%%%%%%%%%%%%
%%%%%%%%%%%%%%%%%%%%%%%
%%%%%%%%%%%%%%%%%%%%%%%
%%%%%%%%%%%%%%%%%%%%%%%
%%%%%%%%%%%%%.......%%%
%%%%%%%%%%%%%%.....%%%%
%%%%%%%%%%%%%%.....%%%%
%%%%%%%%%%%%%%%%.%%%%%%
%%%%%%%%%%%%%%%%%%%%%%%
%%%%%%%%%%%%%%%%%%%%%%%
#
%%%%%%%%%%%%%%%%%%%%%%%
%%%%%%%%%%%%%%%%%%%%%%%
%%%%%%%%%%%%%%%%%%%%%%%
%%%%%%%%%%%%%%%%%%%%%%%
%%%%%%%%%%%%%%%%%%%%%%%
%%%%%%%%%%%%%%%%%%%.%%%
%%%%%%P%%%%%%%%%%%%..%%
%%%%%%%%%%%%%%%%%%%..%%
%%%%%%%%%%%%%%%%%%%..%%
%%%%%%%%%%%%%%%%%%%..%%
%%%%%%%%%%%%%%%%%%%..%%
%%%%%%%%%%%%%%%%%%%.%%%
%%%%%%%%%%%%%%%%%%%%%%%
%%%%%%%%%%%%%%%%%%%%%%%
%%%%%%%%%%%%%%%%%%%%%%%
%%%%%%%%%%%%%%%%%%%%%%%
%%%%%%%%%%%%%%%%%%%%%%%
%%%%%%%%%%%%%%%%%%%%%%%
#
%%%%%%%%%%%%%%%%%%%%%%%
%%%%%%%%%%%%%%%%.%%%%%%
%%%%%%%%%%%%%%.....%%%%
%%%%%%%%%%%%%%.....%%%%
%%%%%%%%%%%%%.......%%%
%%%%%%%%%%%%%.......%%%
%%%%%%%%%%%%%%%%%%%%%%%
%%%%%%%%%%%%%%%%%%%%%%%
%%%%%%%%%%%%%%%%%%%%%%%
%%%%%%%%%%%%%%%%%%%%%%%
%%%%%%%%%%%%%%%%%%%%%%%
%%%%%%%%%%%%%%%%%%%%%%%
%%%%%%%%%%%%%.......%%%
%%%%%%%%%%%%%%.....%%%%
%%%%%%%%%%%%%%.....%%%%
%%%%%%%%%%%%%%%%.%%%%%%
%%%%%%%%%%%%%%%%%%%%%%%
%%%%%%%%%%%%%%%%%%%%%%%
#
