%%%%%%%%%%%%%%%%%%%%%%%%%%%%%%%%
%%%%%%%%%%%%%%%%%%%%%%%%%%%%%%%%
%%%%%%%%%%%%%%%%%%%%%%%%%%  %%%%
%%%%%% %% %%%%%%%%%%%%%%%%  %%%%
%%%%%% %% % % %%  %%%%%%%%% %%%%
%%%%%% %%%%%%%%%%%%%%%%%%%% %%%%
%%%%%%%%%%%%%%%%%%%%%%%%%%%%%%%%
%%%%%%%%%%%%%%%%%%%%%%%%%%%%%%%%
%%%%%%%%%%%%% %%%%%%%%%%%%%%%%%%
%%%%%  %% % % %%%%%%%%%%%%%%%%%%
%%%%%%%%%%%%%%%%%%%%%%%%%%%%%%%%
%%%%%%%%%%%%%%%%%%%%%%%%%%%%%%%%
%%%%%%%%%%%%%%%%%%%%%%%%%%%%%%%%
%%%%%%%%%%%%%%%%%%%%%%%%%%%%%%%%
%%%%%  %%%%%%%%%%%%%%%%%%%%%%%%%
%%%%%  %%%%%%%%%%%%%%%%%%%%%%%%%
%%%%% %%%%%%%%%%%%%%%%%%%%%%%%%%
%%%%%%%%%%%%%%%%  %%%%%%%%% %%%%
%%%%%%%%%%%%%%%%  %%%%%%%%% %%%%
%%%%%%%%%%%%%%%%%%%%%%%%%%% %%%%
%%%%%%%%%%%%%%%%%%%%%%%%%%% %%%%
%%%%%%%%%%%%%%%%%%%%%%%%%%%%%%%%
%%%%%  %% % % %% %%%%%%%%%%%%%%%
%%%%%  %% % % %% %%%%%%%%%%%%%%%
%%%%%  %% % % %% %%%%%%%%..%%%%%
%%%%%  %% % % %% %%%%%%%%..%%%%%
%%%%%  %% % % %% %%%%%%%%..%%%%%
%%%%%  %% % % %% %%%%%%%%%%%%%%%
%%%%%  %% % % %% %%%%%%%%%%%%%%%
%%%%%%%%%%%%%%%%%%%%%%%%%%%%%%%%
%%%%%%%%%%%%%%%%%%%%%%%%%%%%%%%%
#
%%%%%%%%%%%%%%%%%%%%%%%%%%%%%%%%
%%%%%%%%%%%%%%%%%%%%%%%%%%%%%%%%
%%%%%%%%%%%%%%%%%%%%%%%%%     %%
%%%%      %%%%%%%%%%%%%%%     %%
%%%%P      %%%%%%%%  %%%%%    %%
%%%%      %%%%%%%%%   %%%%    %%
%%%%%%%%%%%%%%%%%%%%  %%%%    %%
%%%%%%%%%%%%%%%%%%%%%  %%%%   %%
%%%%%%%%%%%%     %%%%  %%%%   %%
%%               %%%%% %%%%%  %%
%%  %%%%%%%%%%%%%%%%%%  %%%%  %%
%%  %%%%%%%%%%%%%%%%%%  %%%%  %%
%%  %%%%%%%%%%%%%%%%%%   %%%  %%
%%  %%%%%%%%%%%%%%%%%%  %%%%  %%
%%       %%%%%%%%%%%%% %%%%%  %%
%%      %%%%%%%%%%%%%%%%%%%   %%
%%     %%%%%%%%%%%%%%%%%%%%   %%
%%    %%%%%%          %%%%    %%
%%   %%%%%%%          %%%%    %%
%%  %%%%%%%%%%%%%%%%%%%%%%    %%
%%  %%%%%%%%%%%%%%%%%%%%%%    %%
%%  %%%%%%%%%%%%%%%%%%%%%%%%%%%%
%%                 %%%%%%%%%%%%%
%%                 %%%%%%%%%%%%%
%%                 %%%  ...  %%%
%%                 %%%  ...  %%%
%%                 %%%  ...  %%%
%%                 %%%%%%%%%%%%%
%%                 %%%%%%%%%%%%%
%%%%%%%%%%%%%%%%%%%%%%%%%%%%%%%%
%%%%%%%%%%%%%%%%%%%%%%%%%%%%%%%%
#
%%%%%%%%%%%%%%%%%%%%%%%%%%%%%%%%
%%%%%%%%%%%%%%%%%%%%%%%%%%%%%%%%
%%%%%%%%%%%%%%%%%%%%%%%%%%%%%%%%
%%%%%%%%%%%%%%%%%%%%%%%%%%%%%%%%
%%%%%%%%%%%%%%%%%%%%%%%%%%%   %%
%%%%%%%%%%%%%%%%%%%%%%%%%%%   %%
%%%%%%%%%%%%%%%%%%%%% %%%%%   %%
%%%%%%%%%%%%%%%%%%%%% %%%%%   %%
%%%%%%%%%%%%%%%%%%%%%  %%%%   %%
%%%%%%%%%%%%%%%%%%%%%% %%%%%  %%
%%%%%%%%%%%%%%%%%%%%%%  %%%%  %%
%%% %%%%%%%%%%%%%%%%%%  %%%%  %%
%%% %%%%%%%%%%%%%%%%%%  %%%%  %%
%%% %%%%%%%%%%%%%%%%%% %%%%%  %%
%%% %%%%%%%%%%%%%%%%%% %%%%%  %%
%%%  %%%%%%%%%%%%%%%%% %%%%%  %%
%%%  %%%%%%%%%%%%%%%%% %%%%   %%
%%%  %%%%%%%%%%%%%%%%% %%%%   %%
%%% %%%%%%%%%%%%%%%%%% %%%%   %%
%%% %%%%%%%%%%%%%%%%%% %%%%%%%%%
%%% %%%%%%%%%%%%%%%%%% %%%%%%%%%
%%% %%%%%%%%%%%%%%%%%% %%%%%%%%%
%%% %%%%%%%%%%%%%%%%%% %%%%%%%%%
%%%  %%%%%%%%%%%%%%%%% %%%%%%%%%
%%%  %    %        %%% %%%%%%%%%
%%%  %    %        %%%%%%%%%%%%%
%%%  %    %        %%%%%%%%%%%%%
%%%%%%%%%%%%%%%%%%%%%%%%%%%%%%%%
%%%%%%%%%%%%%%%%%%%%%%%%%%%%%%%%
%%%%%%%%%%%%%%%%%%%%%%%%%%%%%%%%
%%%%%%%%%%%%%%%%%%%%%%%%%%%%%%%%
#
