%%%%%%%%%%%%%%%%%%%%%%%
%%%%%%%%%%%%%%%%%%%%%%%
%%%%  %%%%%%%%%%%%%%%%%
%%%%  %%%%%%%%%%% %%%%%
%%%%  %%%%%%%..%% %%%%%
%%%%  %%%%%%%%%%% %%%%%
%%%%  %%%%%%%%%%%%%%%%%
%%%%   %%  %%%%%%%%%%%%
%%%%%%%%%%%%%%%%%%%%%%%
%%%%%%%%%%%%%%%%%%%%%%%
%%%%%%%%%%%%%%%%%%%%%%%
%%%%   %% %%%%%%%%%%%%%
%%%%   %%  %%  %% %%%%%
%%%%   %%  %%%%%%%%%%%%
%%%%%%%%%%%%%%%%%%%%%%%
%%%%%%%%%%%%%%%%%%%%%%%
%%%%%%%%%%%%%% %%  %%%%
%%%%   %%  %%  %%  %%%%
%%%%   %%  %%  %%  %%%%
%%%%%%%%%%%%%%%%%%%%%%%
%%%%%%%%%%%%%%%%%%%%%%%
#
%%%%%%%%%%%%%%%%%%%%%%%
%%%%%%%%%%%%%%%%%%%%%%%
%%      %%%%%%%%%%%%%%%
%%      %%%%%%%%    %%%
%%      %%%%%%%     %%%
%%      %%%%%%%%    %%%
%%      %%%%%%%%%%%%%%%
%%      %%%%%%%%%%%%%%%
%%%%%%%%%%%%%%%%%%%%%%%
%%%%%%%%%%%%%%%%%%% %%%
%%%%%%%%%%%%%%%%%%  %%%
%%        %%%%%%%   %%%
%% P         %%%    %%%
%%        %%%%%%%%%%%%%
%%%%%%%%%%%%%%%%%%%%%%%
%%%%%%%%%%%%%%%%%%%%%%%
%%%%%%%%%%%%%%%      %%
%%                   %%
%%                   %%
%%%%%%%%%%%%%%%%%%%%%%%
%%%%%%%%%%%%%%%%%%%%%%%
#
%%%%%%%%%%%%%%%%%%%%%%%
%%%%%%%%%%%%%%%%%%%%%%%
%%%%%%%%%%%%%%%%%%%%%%%
%%%%%%%%%%%%%%%%%%%%%%%
%%      %%%%%%%%%%%%%%%
%%      %%%%%%%%%%% %%%
%%%%%%%%%%%%%%%%%%% %%%
%%%%%%%%%%%%%%%%%%% %%%
%%%%%%%%%%%%%%%%%%% %%%
%%%%%%%%%%%%%%%%%%% %%%
%%%%%%%%%%%%%%%%%%% %%%
%%%%%%%%%%%%%%%%%%%%%%%
%%%%%%%%%%%%%%%%%%%%%%%
%%%%%%%%%%%%%%%%%%%%%%%
%%%%%%%%%%%%%%%%%%%%%%%
%%%%%%%%%%%%%%%%%%%%%%%
%%%%%%%%%%%%%%%%%%%%%%%
%%%%%%%%%%%%%%%%%%%%%%%
%%%%%%%%%%%%%%%%%%%%%%%
%%%%%%%%%%%%%%%%%%%%%%%
%%%%%%%%%%%%%%%%%%%%%%%
#
