%%%%%%%%%%%%%%%%%%%%%%%%%%%%%%%%%%%%%%%%%%%%%
%%%%%%%%%%%%%%%%%%%%%%%%%%%%%%%%%%%%%%%%%%%%%
%%%%%%        % %     %%%%%%%%%%%%%%%%%%%%%%%
%%%%%%        % %     %%%%%%%%%%%%%%%%%%%%%%%
%%%%%%       %%%%%%%%%%%%%%%%%%%%    %%%%%%%%
%%%%%%       %%%%%%%%%%%%%%%%%%%%    %%%%%%%%
%%%%%%       %%%%%%%%%%%%%%%%%%%%    %%%%%%%%
%%%%%%       %%%%%%%%%%%%.... %%%    %%%%%%%%
%%%%%%       %%%%%%%%%%%%.....%%%    %%%%%%%%
%%%%%%       %%%%%%%%%%%%.... %%%    %%%%%%%%
%%%%%%       %%%%%%%%%%%%%%%%%%%%    %%%%%%%%
%%%%%%       %%%%%%%%%%%%%%%%%%%%    %%%%%%%%
%%%%%%       %%%%%%%%%%%%%%%%%%%%    %%%%%%%%
%%%%%%        % %     %%%%%%%%%%%%%%%%%%%%%%%
%%%%%%        % %     %%%%%%%%%%%%%%%%%%%%%%%
%%%%%%        % %     %%%%%%%%%%%%%%%%%%%%%%%
%%%%%%        % %     % %  %%%%%%%%%%%%%%%%%%
%%%%%%%%%%%%%%%%%%%%%%%%%%%%%%%%%%%%%%%%%%%%%
%%%%%%%%%%%%%%%%%%%%%%%%%%%%%%%%%%%%%%%%%%%%%
%%%%%%%%%%%%%%%%%%%%%%%%%%%%%%%%%%%%%%%%%%%%%
%%%%%%        % %%%%%%%%%%%%%%%%%%%% %%%%%%%%
%%%%%%        % %  %%%%%%%%%%%%%%%%  %%%%%%%%
%%%%%%        % %     %%%%%%%%%%%%   %%%%%%%%
%%%%%%        % %     % %     %%%    %%%%%%%%
%%%%%%        % %     % %     %%%    %%%%%%%%
%%%%%%        % %     % %     %%%    %%%%%%%%
%%%%%%        % %     % %     %%%    %%%%%%%%
%%%%%%        % %    %%%%%%%%%%%%%%%%%%%%%%%%
%%%%%%        % %%%%%%%%%%%%%%%%%%%%%%%%%%%%%
%%%%%%%%%%%%%%%%%%%%%%%%%%%%%%%%%%%%%%%%%%%%%
%%%%%%%%%%%%%%%%%%%%%%%%%%%%%%%%%     %%%%%%%
%%%%%%%%%%%%%%%%%%%%%%%%%%%%  %%%     %%%%%%%
%%%%%%        % %     % %     %%%     %%%%%%%
%%%%%%        % %     % %     %%%     %%%%%%%
%%%%%%        % %     % %     %%%     %%%%%%%
%%%%%%        % %     % %     %%%     %%%%%%%
%%%%%%        % %     % %     %%%     %%%%%%%
%%%%%%        % %     % %     %%%     %%%%%%%
%%%%%%        % %     % %     %%%     %%%%%%%
%%%%%%%%%%%%%%%%%%%%%%%%%%%%%%%%%%%%%%%%%%%%%
%%%%%%%%%%%%%%%%%%%%%%%%%%%%%%%%%%%%%%%%%%%%%
#
%%%%%%%%%%%%%%%%%%%%%%%%%%%%%%%%%%%%%%%%%%%%%
%%%%%%%%%%%%%%%%%%%%%%%%%%%%%%%%%%%%%%%%%%%%%
%%%%%%%%%%%%%%%%%%%%%%%%%%%%%%%%%%%%%%%%%%%%%
%%%%%%%%%%%%%%%%%%%%%%%%%%%%%%%%%%%%%%%%%%%%%
%%%%           %%%%%%%%%%%%%%%%%%%%%%%%%%%%%%
%%%%           %%%%%%%%%%%%%%%%%%%%%%%%%%%%%%
%%%%           %%%%%%%%%%%%%%%         %%%%%%
%%%%           %%%%%%%%%%%%%%          %%%%%%
%%%%           %%%%%%%%%%%%%           %%%%%%
%%%%           %%%%%%%%%%%%%%          %%%%%%
%%%%           %%%%%%%%%%%%%%%         %%%%%%
%%%%           %%%%%%%%%%%%%%%%%%%%%%  %%%%%%
%%%%           %%%%%%%%%%%%%%%%%%%%%%% %%%%%%
%%%%            %%%%%%%%%%%%%%%%%%%%%%%%%%%%%
%%%%             %%%%%%%%%%%%%%%%%%%%%%%%%%%%
%%%%%%%%%%%%%%%%%%%%%%   %%%%%%%%%%%%%%%%%%%%
%%%%%%%%%%%%%%%%%%%%%%%%  %%%%%%%%%%%% %%%%%%
%%%%%%%%%%%%%%%%%%%%%%%%%%%%%%%%%%%%%  %%%%%%
%%%%%%%%%%%%%%%%%%%%%%%%%%%%%%%%%%%%   %%%%%%
%%%%%%%%%%%%%%%%%%%%%%%%%%%%%%%%%%%    %%%%%%
%%%%%%%%%%%%%%%%%%%%%%%%%%%%%%%%%%     %%%%%%
%%%%%%%%%%%%%%%%%%%%%%%%%%%%%%%%%      %%%%%%
%%%%                  %%%%%%%%%%       %%%%%%
%%%%                     %%%%%%        %%%%%%
%%%%  P                    %%%         %%%%%%
%%%%                       %%%%%%%%%%%%%%%%%%
%%%%                   %%%%%%%%%%%%%%%%%%%%%%
%%%%%%%%%%%%%%%%%%%%%%%%%%%%%%%%%%%%%%%%%%%%%
%%%%%%%%%%%%%%%%%%%%%%%%%%%%%%%%%%%%%%%%%%%%%
%%%%%%%%%%%%%%%%%%%%%%%%%%%%%%%%%%%%%%%%%%%%%
%%%%%%%%%%%%%%%%%%%%%%%%%%%%%%%%%%%%%%%%%%%%%
%%%%%%%%%%%%%%%%%%%%%%%%%%%%%%%%%%%%%%%%%%%%%
%%%%%%%%%%%%%%%%%%%%%%%%%%               %%%%
%%%%%%%%%%%%%%%%%%%%%%                   %%%%
%%%%                                     %%%%
%%%%                                     %%%%
%%%%                                     %%%%
%%%%%%%%%%%%%%%%%%%%%%%%%%%%%%%%%%%%%%%%%%%%%
%%%%%%%%%%%%%%%%%%%%%%%%%%%%%%%%%%%%%%%%%%%%%
%%%%%%%%%%%%%%%%%%%%%%%%%%%%%%%%%%%%%%%%%%%%%
%%%%%%%%%%%%%%%%%%%%%%%%%%%%%%%%%%%%%%%%%%%%%
#
%%%%%%%%%%%%%%%%%%%%%%%%%%%%%%%%%%%%%%%%%%%%%
%%%%%%%%%%%%%%%%%%%%%%%%%%%%%%%%%%%%%%%%%%%%%
%%%%%%%%%%%%%%%%%%%%%%%%%%%%%%%%%%%%%%%%%%%%%
%%%%%%%%%%%%%%%%%%%%%%%%%%%%%%%%%%%%%%%%%%%%%
%%%%%%%%%%%%%%%%%%%%%%%%%%%%%%%%%%%%%%%%%%%%%
%%%%%%%%%%%%%%%%%%%%%%%%%%%%%%%%%%%%%%%%%%%%%
%%               %%%%%%%%%%%%%%%%%%%%%%%%%%%%
%%               %%%%%%%%%%%%%%%%%%%%%%%%%%%%
%%               %%%%%%%%%%%%            %%%%
%%               %%%%%%%%%%%%%%%%%%%%    %%%%
%%               %%%%%%%%%%%%%%%%%%%%    %%%%
%%               %%%%%%%%%%%%%%%%%%%%    %%%%
%%               %%%%%%%%%%%%%%%%%%%%    %%%%
%%%%%%%%%%%%%%%%%%%%%%%%%%%%%%%%%%%%%    %%%%
%%%%%%%%%%%%%%%%%%%%%%%%%%%%%%%%%%%%%    %%%%
%%%%%%%%%%%%%%%%%%%%%%%%%%%%%%%%%%%%%    %%%%
%%%%%%%%%%%%%%%%%%%%%%%%%%%%%%%%%%%%%    %%%%
%%%%%%%%%%%%%%%%%%%%%%%%%%%%%%%%%%%%%    %%%%
%%%%%%%%%%%%%%%%%%%%%%%%%%%%%%%%%%%%%    %%%%
%%%%%%%%%%%%%%%%%%%%%%%%%%%%%%%%%%%%%    %%%%
%%%%%%%%%%%%%%%%%%%%%%%%%%%%%%%%%%%%     %%%%
%%%%%%%%%%%%%%%%%%%%%%%%%%%%%%%%%%%      %%%%
%%%%%%%%%%%%%%%%%%%%%%%%%%%%%%%%%%       %%%%
%%%%%%%%%%%%%%%%%%%%%%%%%%%%%%%%%%%%%%%%%%%%%
%%                %  %%%%%%%%%%%%%%%%%%%%%%%%
%%%%%%%%%%%%%%%%%%%%%%%%%%%%%%%%%%%%%%%%%%%%%
%%%%%%%%%%%%%%%%%%%%%%%%%%%%%%%%%%%%%%%%%%%%%
%%%%%%%%%%%%%%%%%%%%%%%%%%%%%%%%%%%%%%%%%%%%%
%%%%%%%%%%%%%%%%%%%%%%%%%%%%%%%%%%%%%%%%%%%%%
%%%%%%%%%%%%%%%%%%%%%%%%%%%%%%%%%%%%%%%%%%%%%
%%%%%%%%%%%%%%%%%%%%%%%%%%%%%%%%%%%%%%%%%%%%%
%%%%%%%%%%%%%%%%%%%%%%%%%%%%%%%%%%%%%%%%%%%%%
%%%%%%%%%%%%%%%%%%%%%%%%%%%%%%%%%%%%%%%%%%%%%
%%%%%%%%%%%%%%%%%%%%%%%%%%%%%%%%%%%%%%%%%%%%%
%%%%%%%%%%%%%%%%%%%%%%%%%%%%              %%%
%%%%%%%%%%%%%%%%%%%%%%%%%%%%%%%%%%%%%%%%%%%%%
%%%%%%%%%%%%%%%%%%%%%%%%%%%%%%%%%%%%%%%%%%%%%
%%%%%%%%%%%%%%%%%%%%%%%%%%%%%%%%%%%%%%%%%%%%%
%%%%%%%%%%%%%%%%%%%%%%%%%%%%%%%%%%%%%%%%%%%%%
%%%%%%%%%%%%%%%%%%%%%%%%%%%%%%%%%%%%%%%%%%%%%
%%%%%%%%%%%%%%%%%%%%%%%%%%%%%%%%%%%%%%%%%%%%%
#
