%%%%%%%%%%%%%%%%%%%%%%%%%%%%%%%%%%%%%%%%%%%%%%%%%%%%%%%%%%%%%%%%%%%%%%%%%
%%%%%%%%%%%%%%%%%%%%%%%%%%%%%%%%%%%%%%%%%%%%%%%%%%%%%%%%%%%%%%%%%%%%%%%%%
%%%%%%%%%%%%%%%%%%%%%%%%%%% % %     % % %   % % %   % % %       % %%%%%%%
%%%%%%%%%%%%%%%%%%%%%%%%%%%%% %     % % %   % % %   % % %       % %%%%%%%
%%%%%%%%%%    % %%%%%%%%%%%%% %     % % %   % % %   % % %       % %%%%%%%
%%%%%%%%%%    % %%%%%%%%%%%%%%%%%%%%%%%%%%%%%%%%%%  % % %       % %%%%%%%
%%%%%%%%%%    % % %%%%%%%%%%%%%%%%%%%%%%%%%%%%%%%%% % % %       % %%%%%%%
%%%%%%%%%%    % %  %%%%%%%%%%%%%%%%%%%%%%%%%%%%%%%% % % %       % %%%%%%%
%%%%%%%%%%    % %   %   %   % %     % %%%%%%%%%%%%%%% % %       % %%%%%%%
%%%%%%%%%%    % %   %   %   % %     % % %%%%%%%%%%%%% % %       % %%%%%%%
%%%%%%%%%%    % %   %   %   % %     % % %%%%%%%%%%%%% % %       % %%%%%%%
%%%%%%%%%%    % %   %   %   % %     % % %%%%%%%%%%%%% % %       % %%%%%%%
%%%%%%%%%%    % %  %%%%%%%%%%%%%%%%%%%%%%%%%%%%%%%%%%%% %       % %%%%%%%
%%%%%%%%%%    % %%%%%%%%%%%%%%%%%%%%%%%%% %%%%%%%%%%%%% %       % %%%%%%%
%%%%%%%%%%    % %%%%%%%%%%%%%%%%%%%%%%%%% %%%%%%%%%%%%% %       % %%%%%%%
%%%%%%%%%%%%%%%%%%%%%%%%%%%%%%%%%%%%%%%%%  %%%%%%%%%%%% %       % %%%%%%%
%%%%%%%%%%%%%%%%%%%%%%%%%%%%% %%%%%%%%%%%% %%%%%%%%%%%%%%       % %%%%%%%
%%%%%%%%%%%%%%%%%%%%%%%%%%  %%%%%%%%%%%%%%  %%%%%%%%%%%%%       % %%%%%%%
%%%%%%% %     % %   %   %%%%%%%%%%%%%%%%%%  %%%%%%%%%%%%%       % %%%%%%%
%%%%%%% %     % %   %%%%%%%%%%%%%%%%%%%%%%  %%%%%%%%%%%%%       % %%%%%%%
%%%%%%% %     % %%%%%%%%%%%%%%%%%%%%%%%%%   %%%%%%%%%%%%%%      % %%%%%%%
%%%%%%% %  %%%%%%%%%%%%%%%%%%%%%%%%%% % %   % %%%%%%%%%%%%%%%%%%%%%%%%%%%
%%%%%%%%%%%%%%%%%%%%%%%%%%%%%%%     % % %   % %%%%%%%%%%%%%%%%%%%%%%%%%%%
%%%%%%%%%%%%%%%%%%%%%%%%%%%%%%%%%%%%%%%%%%%%%%%%%%%%%%%%%%%%%%%%%%%%%%%%%
%%%%%%%%%%%%%%%%%%%%%%%%%%%%%%%%%%%%%%%%%%%%%%% %   % % % ......%%%%%%%%%
%%%%%%%%%%%%%%%%%%%%%%%%%%%%%%%%%%%%%%%%%%%%%%%%%%%%%%%%%%%%%%%%%%%%%%%%%
%%%%%%% %     % %   %   %   % %    %%%%%%%%%%%%%%%%%%%%%%%%%%%%%%%%%%%%%%
%%%%%%% %     % %   %   %   % %    %%%%%%%%%%%%%%%%%%%%%%%%%%%%%%%%%%%%%%
%%%%%%% %     % %   %   %   % %    %%%%%%%%%%%%%%%%%%%%%%       % %%%%%%%
%%%%%%% %     %%%%%%%%%%%%%%%%%%%%%%%%%%%%%%%%%%%%%%%%% %       % %%%%%%%
%%%%%%% %     %%%%%%%%%%%%%%%%%%%%%%%%%%%%%%%%%%%%%%%%% %       % %%%%%%%
%%%%%%% %    %%%%%%%%%%%%%%%%%%%%%%%%%%%%%%%%%%%%%%%%%% %       % %%%%%%%
%%%%%%% %   %%%%%%%%%%%%%   % %     % % %  %%%%%%%%%%%% %       % %%%%%%%
%%%%%%% %  %%%%%%%%%%%%%%   % %     % % %  %%%%%%%%%%%% %       % %%%%%%%
%%%%%%% % %%%%%%%%%%%%% %   % %     % % %  %%%%%%%%%%%% %       % %%%%%%%
%%%%%%% %%%%%%%%%%%%%%  %   % %     % % %  %%%%%%%%%%%% %       % %%%%%%%
%%%%%%% %%%%%%%%%%%%%   %   % %     % % %  %%%%%%%%%%%% %       % %%%%%%%
%%%%%%%%%%%%%%%%%%%%%   %   % %     % % %  %%%%%%%%%%%% %       % %%%%%%%
%%%%%%%%%%%%%%%%%%%.%   %   % %     % % %  %%%%%%%%%%%% %       % %%%%%%%
%%%%%%%%%%%%%%%%%%%%%%%%%%%%%%%%%%%%%%%%%%%%%%%%%%%%%%% %       % %%%%%%%
%%%%%%%%%%%%%%%%%%%%%%%%%%%%%%%%%%%%%%%%%%%%%%%%%%%%%%% %       % %%%%%%%
%%%%%%%%%%%%%%%%%%%%%%%%%%%%%%%%%%%%%%%%%%%%%%%%%%%%%%% %       % %%%%%%%
%%%%%%% %     % %   %   %   % %    %%%%%%%%%%%%%%%%%%%% %       % %%%%%%%
%%%%%%% %     % %   %   %   % %    %%%%%%%%%%%%%%%%%%%%%%%%%%%%%%%%%%%%%%
%%%%%%% %     % %   %   %   % %    %%%%%%%%%%%%%%%%%%%%%%%%%%%%%%%%%%%%%%
%%%%%%% %     % %   %   %   % %    %%%%%%%%%%%%%%%%%%%%%%%%%%%%%%%%%%%%%%
%%%%%%% %     % %   %   %   % %    %%%%%%%%%%%% %   % %%%%%%%%%%%%%%%%%%%
%%%%%%% %     % %   %   %   % %    %%%%%%%%%%%% %   % %%%%%%%%%%%%%%%%%%%
%%%%%%% %     % %   %   %   % %    %%%%%%%%%%%%.%...%.%%%%%%%%%%%%%%%%%%%
%%%%%%% %     % %   %   %   % %    %%%%%%%%%%%%.%...%.%%%%%%%%%%%%%%%%%%%
%%%%%%% %     % %   %   %   % %    %%%%%%%%%%%%.%...%.%%%%%%%%%%%%%%%%%%%
%%%%%%% %     % %   %   %   % %    %%%%%%%%%%%%%%%%%%%%%%%%%%%%%%%%%%%%%%
%%%%%%% %     % %   %   %   % %    %%%%%%%%%%%%%%%%%%%%%%%%%%%%%%%%%%%%%%
%%%%%%%%%%%%%%%%%%%%%%%%%%%%%%%%%%%%%%%%%%%%%%%%%%%%%%%%%%%%%%%%%%%%%%%%%
%%%%%%%%%%%%%%%%%%%%%%%%%%%%%%%%%%%%%%%%%%%%%%%%%%%%%%%%%%%%%%%%%%%%%%%%%
#
%%%%%%%%%%%%%%%%%%%%%%%%%%%%%%%%%%%%%%%%%%%%%%%%%%%%%%%%%%%%%%%%%%%%%%%%%
%%%%%%%%%%%%%%%%%%%%%%%%%%%%%%%%%%%%%%%%%%%%%%%%%%%%%%%%%%%%%%%%%%%%%%%%%
%%%%%%%%%%%%%%%%%%%%%%%%%%%%%%%%%%%%%%%%%%%%%%%%%%%%%%%%%%%%%%%%%%%%%%%%%
%%%%%%%%%%%%%%%%%%%%%%%%%%%%%%%%%%%%%%%%%%%%%%%%%%%%%%%%%%%%%%%%%%%%%%%%%
%%%%%%%%%%%%%%%%%%%%%%%%%%%%%%%%%%%%%%%%%%%%%%%                      %%%%
%%%%%%%%%%%%%%%%%%%%%%%%%%%%%%%%%%%%%%%%%%%%%%%%                     %%%%
%%%%%%%%            %%%%%%%%%%%%%%%%%%%%%%%%%%%%                     %%%%
%%%%%%%%             %%%%%%%%%%%%%%%%%%%%%%%%%%%%                    %%%%
%%%%%%%%P             %%%%%%%%%%%%%%%%%%%%%%%%%%%                    %%%%
%%%%%%%%               %%%%%%%%%%%%%%%%%%%%%%%%%%%                   %%%%
%%%%%%%%               %%%%%%%%%%%%%       %%%%%%%                   %%%%
%%%%%%%%              %%%%%%%%%%%%%%%      %%%%%%%%                  %%%%
%%%%%%%%            %%%%%%%%%%%%%%%%%%      %%%%%%%                  %%%%
%%%%%%%%%%%%%%%%%%%%%%%%%%%%%%%%%%%%%%      %%%%%%%%                 %%%%
%%%%%%%%%%%%%%%%%%%%%%%%%%%%%%%%%%%%%%       %%%%%%%                 %%%%
%%%%%%%%%%%%%%%%%%%%%%%%%%%%%%%%%%%%%%%      %%%%%%%%                %%%%
%%%%%%%%%%%%%%%%%%%%%%%%%%%%%%%%%%%%%%%       %%%%%%%                %%%%
%%%%%%%%%%%%%%%%%%%%%%%%%  %%%%%%%%%%%%%      %%%%%%%%               %%%%
%%%%%%%%%%%%%%%%%%%%%%%%%%%%%%%%%%%%%%%%       %%%%%%%               %%%%
%%%%%%%%%%%%%%%%%%%%%%%%%%%%%%%%%%%%%%%%       %%%%%%%%%%%%%%%%%%%%%%%%%%
%%%%          %%%%%%%%%%%%%%%%%%%%%%%%%         %%%%%%%%%%%%%%%%%%%%%%%%%
%%%%     %%%%%%%%%%%%%%%%%%%%%%%%%%%%%%%%%      %%%%%%%%%%%%%%%%%%%%%%%%%
%%%%    %%%%%%%%%%%%%%%%%%%%%%%%%%%%%%%%%%%      %%%%%%%%%%%%%%%%%%%%%%%%
%%%%   %%%%%%%%%%%%%%%%%%%%%%%%%%%%%%%%%%%%%     %%%%%%%%%%%%%%%%%%%%%%%%
%%%%   %%%%%%%%%%%%%%%%%%%%%%%%%%%%%%%%%%%%%    %%%%%%%%%%%%%%%%%%%%%%%%%
%%%%   %%%%%%%%%%%%%%%%%%%%%%%%%%%%%%%%%%%%%   %%%%%%%%%%%%%%%%%%%%%%%%%%
%%%%    %%%%%%%%%%%%%%%%%%%%%%%%%%%%%%%%%%%%   %%%%%%%%%%%%%%%%%%%%%%%%%%
%%%%     %%%%%%%%%%%%%%%%%%%%%%%%%%%%%%%%%%%   %%%%%%%%%%%%%%%%%%%%%%%%%%
%%%%              %%%%%%%%%%%%%%%%%%%%%%%%%%  %%%%%%%%%%%%%%%%%%%%%%%%%%%
%%%%             %%%%%%%%%%%%%%%%%%%%%%%%%%%  %%%%%%%%%%%%%%%%%%%%%%%%%%%
%%%%            %%%%%%%%%%%%%%%%%%%%%%%%%%%%  %%%%%%%                %%%%
%%%%           %%%%%%%%%%%%%%%%%%%%%%%%%%%%% %%%%%%%                 %%%%
%%%%          %%%%%%%%%%%%%%%%%%%%%%%%%%%%%  %%%%%%%                 %%%%
%%%%         %%%%%%%%%%%%%%%%%%%%%%%%%%%%%   %%%%%%%                 %%%%
%%%%        %%%%%%%%%                        %%%%%%%                 %%%%
%%%%       %%%%%%%%%                         %%%%%%%                 %%%%
%%%%      %%%%%%%%%                          %%%%%%%                 %%%%
%%%%     %%%%%%%%%%%%%%%%%%%%%%%%%%%%%%%%%   %%%%%%%                 %%%%
%%%%    %%%%%%%%%%%%%%%%%%%%%%%%%%%%%%%%%%%  %%%%%%%                 %%%%
%%%%   %%%%%%%%%%%%%%%%%%%%%%%%%%%%%%%%%%%%% %%%%%%%                 %%%%
%%%%   %%%%%%%%%%%%%%%%%%%%%%%%%%%%%%%%%%%%% %%%%%%%                 %%%%
%%%%   %%%%%%%%%%%%%%%%%%%%%%%%%%%%%%%%%%%%% %%%%%%%%%%%%%%%%%       %%%%
%%%%    %%%%%%%%%%%%%%%%%%%%%%%%%%%%%%%%%%%% %%%%%%%%%%%%%%%%%%      %%%%
%%%%     %%%%%%%%%%%%%%%%%%%%%%%%%%%%%%%%%%% %%%%%%%%%%%%%%%%%%%     %%%%
%%%%                                 %%%%%%% %%%%%%%%%%%%%%%%%%%     %%%%
%%%%                                 %%%%%%% %%%%%%%%%%%%%%%%%%%     %%%%
%%%%                                 %%%%%%%  %%%%%%%%%%%%%%%%%%     %%%%
%%%%                                 %%%%%%%   %%%%%%%%%%%%%%%%%     %%%%
%%%%                                 %%%%%%%    .....    %%%%%%%     %%%%
%%%%                                 %%%%%%%%%%%%%%%%%%%%%%%%%%%     %%%%
%%%%                                 %%%%%%%%%%%%%%%%%%%%%%%%%%%     %%%%
%%%%%%%%%%%%%%%%%%%%%%%%%%%%%%%%%%%%%%%%%%%%%%%%%%%%%%%%%%%%%%%%%%%%%%%%%
%%%%%%%%%%%%%%%%%%%%%%%%%%%%%%%%%%%%%%%%%%%%%%%%%%%%%%%%%%%%%%%%%%%%%%%%%
%%%%%%%%%%%%%%%%%%%%%%%%%%%%%%%%%%%%%%%%%%%%%%%%%%%%%%%%%%%%%%%%%%%%%%%%%
%%%%%%%%%%%%%%%%%%%%%%%%%%%%%%%%%%%%%%%%%%%%%%%%%%%%%%%%%%%%%%%%%%%%%%%%%
#
%%%%%%%%%%%%%%%%%%%%%%%%%%%%%%%%%%%%%%%%%%%%%%%%%%%%%%%%%%%%%%%%%%%%%%%%%
%%%%%%%%%%%%%%%%%%%%%%%%%%%%%%%%%%%%%%%%%%%%%%%%%%%%%%%%%%%%%%%%%%%%%%%%%
%%%%%%%%%%%%%%%%%%%%%%%%%%%%%%%%%%%%%%%%%%%%%%%%%%%%%%%%%%%%%%%%%%%%%%%%%
%%%%%%%%%%%%%%%%%%%%%%%%%%%%%%%%%%%%%%%%%%%%%%%%%%%%%%%%%%%%%%%%%%%%%%%%%
%%%%%%%%%%%%%%%%%%%%%%%%%%%%%%%%%%%%%%%%%%%%%%%%%%%%%%%%%%%%%%%%%%%%%%%%%
%%%%%%%%%%%%%%%%%%%%%%%%%%%%%%%%%%%%%%%%%%%%%%%%%%%%%%%%%%%%%%%%%%%%%%%%%
%% %%%%%%%%%%%%%%%%%%%%%%%%%%%%%%%%%%%%%%%%%%%%%%           %         %%%
%% %%%%%%%%%%%%%%%%%%%%%%%%%%%%%%%%%%%%%%%%%%%%%%           %         %%%
%% %%%              %%%%%%%%%%%%%%%%%%%%%%%%%%%%%%          %         %%%
%% %%%               %%%%%%%%%%%%%%%%%%%%%%%%%%%%%          %         %%%
%% %%%              %%%%%%%%%%%%%%%%%%%%%%%%%%%%%%%         %         %%%
%% %%%%%%%%%%%%%%%%%%%%%%%%%%%%%%%%%%%%%%%%%%%%%%%%         %         %%%
%% %%%%%%%%%%%%%%%%%%%%%%%%%%%%%%%%%%%  %  %%%%%%%%%        %         %%%
%% %%%%%%%%%%%%%%%%%%%%%%%%%%%%%%%%%%%  %   %%%%%%%%        %         %%%
%% %%%%%%%%%%%%%%%%%%%%%%%%%%%%%%%%%%%  %   %%%%%%%%%       %         %%%
%% %%%%%%%%%%%%%%%%%%%%%%%%%%%%%%%%%%%  %    %%%%%%%%       %         %%%
%% %%%%%%%%%%%%%%%%%%%%%%%%%%%%%%%%%%%  %    %%%%%%%%%      %         %%%
%% %%%%%%%%%%%%%%%%%%%%%%%%%%%%%%%%%%%  %     %%%%%%%%%%%%%%%%%%%%%%%%%%%
%% %%%%%%%%%%%%%%%%%%%%%%%%%%%%%%%%%%%  %     %%%%%%%%%%%%%%%%%%%%%%%%%%%
%% %%%%%%%%%%%%%%%%%%%%%%%%%%%%%%%%%%%%%%%     %%%%%%%%%%%%%%%%%%%%%%%%%%
%% %%%%%%%%%%%%%%%%%%%%%%%%%%%%%%%%%%%%%%%     %%%%%%%%%%%%%%%%%%%%%%%%%%
%% %%%%%%%%%%%%%%%%%%%%%%%%%%%%%%%%%%%%%%%      %%%%%%%%%%%%%%%%%%%%%%%%%
%%  %    %%%%%%%%%%%%%%%%%%%%%%%%%%%%%%%%%      %%%%%%%%%%%%%%%%%%%%%%%%%
%%  %    %%%%%%%%%%%%%%%%%%%%%%%%%%%%%%%%%      %%%%%%%%%%%%%%%%%%%%%%%%%
%%  %    %%%%%%%%%%%%%%%%%%%%%%%%%%%%%%%%%      %%%%%%%%%%%%%%%%%%%%%%%%%
%%  %    %%%%%%%%%%%%%%%%%%%%%%%%%%%%%%%%%      %%%%%%%%%%%%%%%%%%%%%%%%%
%%  %    %%%%%%%%%%%%%%%%%%%%%%%%%%%%%%%%%     %%%%%%%%%%%%%%%%%%%%%%%%%%
%%  %    %%%%%%%%%%%%%%%%%%%%%%%%%%%%%%%%%     %%%%%%%%%%%%%%%%%%%%%%%%%%
%%  %    %%%%%%%%%%%%%%%%%%%%%%%%%%%%%%%%%     %%%%%%%%%%%%%%%%%%%%%%%%%%
%%  %    %%%%%%%%%%%%%%%%%%%%%%%%%%%%%%%%%     %%%%%%%%%%%%%%%%%%%%%%%%%%
%%  %         %%%%%%%%%%%%%%%%%%%%%%%%%%%%     %%%%%%%%%%%%%%%%%%%%%%%%%%
%%  %        %%%%%%%%%%%%%%%%%%%%%%%%%%%%%     %%%%%%%%%%%%%%%%%%%%%%%%%%
%%  %       %%%%%%%%%%%%%%%%%%%%%%%%%%%%%%     %%%%%        %         %%%
%%  %      %%%%%%%%%%%%%%%%%%%%%%%%%%%%%%%     %%%%         %         %%%
%%  %     %%%%%%%%%%%%%%%%%%%%%%%%%%%%%%%%     %%%%         %         %%%
%%  %    %%%%%%%%%%%%%%%%%%%%%%%%%%%%%%%%%     %%%%         %         %%%
%%  %    %%%%%%%%%%%%%%%%%%%%%%%%%%%%%%%%%     %%%          %         %%%
%%  %    %%%%%%%%%%%%%%%%%%%%%%%%%%%%%%%%%     %%%          %         %%%
%%  %    %%%%%%%%%%%%%%%%%%%%%%%%%%%%%%%%%     %%%          %         %%%
%%  %    %%%%%%%%%%%%%%%%%%%%%%%%%%%%%%%%%     %%%%%%%%%%%%%%%        %%%
%%  %    %%%%%%%%%%%%%%%%%%%%%%%%%%%%%%%%%     %%%%%%%%%%%%%%%        %%%
%%  %    %%%%%%%%%%%%%%%%%%%%%%%%%%%%%%%%%     %%%%%%%%%%%%%%%        %%%
%%  %    %%%%%%%%%%%%%%%%%%%%%%%%%%%%%%%%%     %%%%%%%%%%%%%%%        %%%
%%  %    %%%%%%%%%%%%%%%%%%%%%%%%%%%%%%%%%     %%%%%%%%%%%%%%%        %%%
%%  %    %%%%%%%%%%%%%%%%%%%%%%%%%%%%%%%%%     %%%%%%%%%%%%%%%        %%%
%%  %    %%%%%%%%%%%%%%%%%%%%%%%%%%%%%%%%%     %%%%%%%%%%%%%%%        %%%
%%  %                                  %%%     %%%%%%%%%%%%%%%        %%%
%%  %                                  %%%%%%%%%%%%%%%%%%%%%%%        %%%
%%  %                                  %%%%%%%%%%%%%%%%%%%%%%%        %%%
%%%%%%%%%%%%%%%%%%%%%%%%%%%%%%%%%%%%%%%%%%%%%%%%%%%%%%%%%%%%%%%%%%%%%%%%%
%%%%%%%%%%%%%%%%%%%%%%%%%%%%%%%%%%%%%%%%%%%%%%%%%%%%%%%%%%%%%%%%%%%%%%%%%
%%%%%%%%%%%%%%%%%%%%%%%%%%%%%%%%%%%%%%%%%%%%%%%%%%%%%%%%%%%%%%%%%%%%%%%%%
%%%%%%%%%%%%%%%%%%%%%%%%%%%%%%%%%%%%%%%%%%%%%%%%%%%%%%%%%%%%%%%%%%%%%%%%%
%%%%%%%%%%%%%%%%%%%%%%%%%%%%%%%%%%%%%%%%%%%%%%%%%%%%%%%%%%%%%%%%%%%%%%%%%
%%%%%%%%%%%%%%%%%%%%%%%%%%%%%%%%%%%%%%%%%%%%%%%%%%%%%%%%%%%%%%%%%%%%%%%%%
#
