%%%%%%%%%%%%%%%%%%%%%%%%%%%%%%%%%%%%%%%%%%%%%%%%%%%%%%%%%%%%%%%
%%%%%%%%%%%%%%%%%%%%%%%%%%%%%%%%%%%%%%%%%%%%%%%%%%%%%%%%%%%%%%%
%%%%%%%%%%%%%%%%%%%%%%%%%%%%% %     % % %  %%   %  %    %%%%%%%
%%%%%%%%%%%%%%%%%%%%%%%%%%%%%%%%%%%%%%%%%%%%%%%%%% %    %%%%%%%
%%%%%%%%%%    % %%%%%%%%%%%%%%%%%%%%%%%%%%%%%%%%%% %    %%%%%%%
%%%%%%%%%%    % % %%%%%%%%%%%%%%%%%%%%%%%%%%%%%%%%%%    %%%%%%%
%%%%%%%%%%    % %   %   %   % %     % %%%%%%%%%%%%%%    %%%%%%%
%%%%%%%%%%    % %   %   %   % %     % % %%%%%%%%%%%%    %%%%%%%
%%%%%%%%%%    % %   %   %   % %     % % %%%%%%%%%%%%    %%%%%%%
%%%%%%%%%%    % %   %   %   % %     % % %%%%%%%%%%%%%   %%%%%%%
%%%%%%%%%%    % %  %%%%%%%%%%%%%%%%%%%%%%%%%%%%%%%%%%   %%%%%%%
%%%%%%%%%%    % %%%%%%%%%%%%%%%%%%%%%%%%% %%%%%%%%%%%%  %%%%%%%
%%%%%%%%%%    % %%%%%%%%%%%%%%%%%%%%%%%%% %%%%%%%%%%%%  %%%%%%%
%%%%%%%%%%%%%%%%%%%%%%%%%%%%% %%%%%%%%%%%% %%%%%%%%%%%  %%%%%%%
%%%%%%%%%%%%%%%%%%%%%%%%%%%%% %%%%%%%%%%%% %%%%%%%%%%%% %%%%%%%
%%%%%%%%%%%%%%%%%%%%%%%%%%  % %%%%%%%%%%%%%%%%%%%%%%%%% %%%%%%%
%%%%%%% %     % %   %   %   % %%%%%%%%%%%%%%%%%%%%%%%%%%%%%%%%%
%%%%%%% %     % %   %   %   % % %%%%%%%%%%%%%%%%%%%%%%%%%%%%%%%
%%%%%%% %     % %   %   %   % % %%%%%%%%%%%%%%%%%%%%%%%%%%%%%%%
%%%%%%% %     % %   %   %   % %  %%%%%%%%%%%%%%%%%%%%%%%%%%%%%%
%%%%%%% %     % %   %   %   % %  %%%%%%%%%%%% %%%%%%%%%%%%%%%%%
%%%%%%%%%%%%%%%%%%%%%%%%%%%%%%%%%%%%%%%%%%%%%%%%%%%%%%%%%%%%%%%
%%%%%%%%%%%%%%%%%%%%%%%%%%%%%%%%%%%%%%%%%%%%%% %%%%%%%%%%%%%%%%
%%%%%%%%%%%%%%%%%%%%%%%%%%%%%%%%%%%%%%%%%%%%%% %%%%%%%%%%%%%%%%
%%%%%%%%%%%%%%%%%%%%%%%%%%%%%%%%%%%%%%%%%%%%%% %%%%%%%%%%%%%%%%
%%%%%%%%%%%%%%%%%%%%%%%%%%%%%%%%%%%%%%%%%%%%%% %%%%%%%%%%%%%%%%
%%%%%%% %     % %   %   %   % %    %%%%%%%%%%%%%%%%%%%%%%%%%%%%
%%%%%%% %     % %   %   %   % %    %%%%%%%%%%%%%%%%%%%%%%%%%%%%
%%%%%%% %     % %   %   %   % %    %%%%%%%%%%%%%%%%%%%%%%%%%%%%
%%%%%%% %     %%%%%%%%%%%%%%%%%%%%%%%%%%%%%%%%%%%%%%%%%%%%%%%%%
%%%%%%% %     %%%%%%%%%%%%%%%%%%%%%%%%%%%%%%%%%%%%%%%%%%%%%%%%%
%%%%%%% %    %%%%%%%%%%%%%%%%%%%%%%%%%%%%%%%%%%%%%%%%%% %%%%%%%
%%%%%%% %   %%%%%%%%%%%%%%  % %     % % % %%%%%%%%%%%%  %%%%%%%
%%%%%%% %  %%%%%%%%%%%%%%%  % %     % % % %%%%%%%%%%%   %%%%%%%
%%%%%%% % %%%%%%%%%%%%%%%%  % %     % % % %%%%%%%%%%%   %%%%%%%
%%%%%%% %%%%%%%%%%%%%%%%%%  % %     % % % %%%%%%%%%%%   %%%%%%%
%%%%%%% %%%%%%%%%%%%%%%%%%  % %     % % % %%%%%%%%%%%   %%%%%%%
%%%%%%%%%%%%%%%%%%%%%%%%%%  % %     % % % %%%%%%%%%%%   %%%%%%%
%%%%%%%%%%%%%%%%%%%%%%%%%%  % %     % % % %%%%%%%%%%%   %%%%%%%
%%%%%%%%%%%%%%%%%%%%%%%%%%%%%%%%%%%%%%%%%%%%%%%%%%%%%   %%%%%%%
%%%%%%%%%%%%%%%%%%%%%%%%%%%%%%%%%%%%%%%%%%%%%%%%%%%%%   %%%%%%%
%%%%%%%%%%%%%%%%%%%%%%%%%%%%%%%%%%%%%%%%%%%%%%%%%%%%%   %%%%%%%
%%%%%%% %     % %   %   %   % %    %%%%%%%%%%%%%%%%%%   %%%%%%%
%%%%%%% %     % %   %   %   % %    %%%%%%%%%%%%%%%%%%%%%%%%%%%%
%%%%%%% %     % %   %   %   % %    %%%%%%%%%%%%%%%%%%%%%%%%%%%%
%%%%%%% %     % %   %   %   % %    %%%%%%%%%%%%%%%%%%%%%%%%%%%%
%%%%%%% %     % %   %   %   % %    %%%%%%%%%%%  %  %   %%%%%%%%
%%%%%%% %     % %   %   %   % %    %%%%%%%%%%%  %  %   %%%%%%%%
%%%%%%% %     % %   %   %   % %    %%%%%%%%%%%..%..%...%%%%%%%%
%%%%%%% %     % %   %   %   % %    %%%%%%%%%%%..%..%...%%%%%%%%
%%%%%%% %     % %   %   %   % %    %%%%%%%%%%%..%..%...%%%%%%%%
%%%%%%% %     % %   %   %   % %    %%%%%%%%%%%..%..%...%%%%%%%%
%%%%%%% %     % %   %   %   % %    %%%%%%%%%%%..%..%...%%%%%%%%
%%%%%%% %     % %   %   %   % %    %%%%%%%%%%%  %  %   %%%%%%%%
%%%%%%% %     % %   %   %   % %    %%%%%%%%%%%  %  %   %%%%%%%%
%%%%%%% %     % %   %   %   % %    %%%%%%%%%%%%%%%%%%%%%%%%%%%%
%%%%%%% %     % %   %   %   % %    %%%%%%%%%%%%%%%%%%%%%%%%%%%%
%%%%%%% %     % %   %   %   % %    %%%%%%%%%%%%%%%%%%%%%%%%%%%%
%%%%%%% %     % %   %   %   % %     % % %  %%   %  %    %%%%%%%
%%%%%%%%%%%%%%%%%%%%%%%%%%%%%%%%%%%%%%%%%%%%%%%%%%%%%%%%%%%%%%%
%%%%%%%%%%%%%%%%%%%%%%%%%%%%%%%%%%%%%%%%%%%%%%%%%%%%%%%%%%%%%%%
#
%%%%%%%%%%%%%%%%%%%%%%%%%%%%%%%%%%%%%%%%%%%%%%%%%%%%%%%%%%%%%%%
%%%%%%%%%%%%%%%%%%%%%%%%%%%%%%%%%%%%%%%%%%%%%%%%%%%%%%%%%%%%%%%
%%%%%%%%%%%%%%%%%%%%%%%%%%%%%%%%%%%%%%%%%%%%%%%%%%%%%%%%%%%%%%%
%%%%%%%%%%%%%%%%%%%%%%%%%%%%%%%%%%%%%%%%%%%%%%%%%%%%%%%%%%%%%%%
%%%%%%%%%%%%%%%%%%%%%%%%%%%%%%%%%%%%%%%%%%%%%%%%           %%%%
%%%%%%%%%%%%%%%%%%%%%%%%%%%%%%%%%%%%%%%%%%%%%%%%           %%%%
%%%%%%%%             %%%%%%%%%%%%%%%%%%%%%%%%%%%%          %%%%
%%%%%%%%               %%%%%%%%%%%%%%%%%%%%%%%%%%          %%%%
%%%%%%%%P              %%%%%%%%%%%%%       %%%%%%%         %%%%
%%%%%%%%              %%%%%%%%%%%%%%%      %%%%%%%         %%%%
%%%%%%%%            %%%%%%%%%%%%%%%%%%      %%%%%%%        %%%%
%%%%%%%%%%%%%%%%%%%%%%%%%%%%%%%%%%%%%%      %%%%%%%        %%%%
%%%%%%%%%%%%%%%%%%%%%%%%%%%%%%%%%%%%%%%      %%%%%%%       %%%%
%%%%%%%%%%%%%%%%%%%%%%%%%%%%%%%%%%%%%%%      %%%%%%%       %%%%
%%%%%%%%%%%%%%%%%%%%%%%%%%%%%%%%%%%%%%%%     %%%%%%%       %%%%
%%%%%%%%%%%%%%%%%%%%%%%%%        %%%%%%%      %%%%%%%      %%%%
%%%%%%%%%%%%%%%%%%%%%%%           %%%%%%%     %%%%%%%      %%%%
%%%%%%%%%%%%%%%%%%%%%%            %%%%%%%      %%%%%%%     %%%%
%%%%                               %%%%%%%     %%%%%%%     %%%%
%%%%     %%%%%%%%%%%%%%%%%%%%%%%%%%%%%%%%%%     %%%%%%%    %%%%
%%%%    %%%%%%%%%%%%%%%%%%%%%%%%%%%%%%%%%%%     %%%%%%%    %%%%
%%%%   %%%%%%%%%%%%%%%%%%%%%%%%%%%%%%%%%%%%%     %%%%%%%   %%%%
%%%%   %%%%%%%%%%%%%%%%%%%%%%%%%%%%%%%%%%%%%     %%%%%%%   %%%%
%%%%   %%%%%%%%%%%%%%%%%%%%%%%%%%%%%%%%%%%%%     %%%%%%%   %%%%
%%%%   %%%%%%%%%%%%%%%%%%%%%%%%%%%%%%%%%%%%%     %%%%%%%   %%%%
%%%%   %%%%%%%%%%%%%%%%%%%%%%%%%%%%%%%%%%%%%     %%%%%%%   %%%%
%%%%    %%%%%%%%%%%%%%%%%%%%%%%%%%%%%%%%%%%%    %%%%%%%%   %%%%
%%%%     %%%%%%%%%%%%%%%%%%%%%%%%%%%%%%%%%%%   %%%%%%%%%   %%%%
%%%%              %%%%%%%%%%%%%%%%%%%%%%%%%%   %%%%%%%%    %%%%
%%%%             %%%%%%%%%%%%%%%%%%%%%%%%%%%  %%%%%%%%     %%%%
%%%%            %%%%%%%%%%%%%%%%%%%%%%%%%%%% %%%%%%%%      %%%%
%%%%           %%%%%%%%%%%%%%%%%%%%%%%%%%%%%%%%%%%%%%      %%%%
%%%%          %%%%%%%%%%%%%%%%%%%%%%%%%%%%% %%%%%%%%       %%%%
%%%%         %%%%%%%%%%%%%%%%%%%%%%%%%%%%%  %%%%%%%        %%%%
%%%%        %%%%%%%%%%%%                    %%%%%%%        %%%%
%%%%       %%%%%%%%%%%%%                    %%%%%%%        %%%%
%%%%      %%%%%%%%%%%%%%                    %%%%%%%        %%%%
%%%%     %%%%%%%%%%%%%%%%%%%%%%%%%%%%%%%%%  %%%%%%%        %%%%
%%%%    %%%%%%%%%%%%%%%%%%%%%%%%%%%%%%%%%%% %%%%%%%        %%%%
%%%%   %%%%%%%%%%%%%%%%%%%%%%%%%%%%%%%%%%%%%%%%%%%%        %%%%
%%%%   %%%%%%%%%%%%%%%%%%%%%%%%%%%%%%%%%%%%%%%%%%%%        %%%%
%%%%   %%%%%%%%%%%%%%%%%%%%%%%%%%%%%%%%%%%%%%%%%%%%%%%%%%%%%%%%
%%%%    %%%%%%%%%%%%%%%%%%%%%%%%%%%%%%%%%%%%%%%%%%%%%%%%%%%%%%%
%%%%     %%%%%%%%%%%%%%%%%%%%%%%%%%%%%%%%%%%%%%%%%%%%%%%%%%%%%%
%%%%                                 %%%%%%%%%%%%%%%%%%%%%%%%%%
%%%%                                 %%%%%%%%%%%%%%%%%%%%%%%%%%
%%%%                                 %%%%%%% %%%%%%%%%%%%%%%%%%
%%%%                                 %%%%%%%  %%%%%%%%%%%%%%%%%
%%%%                                 %%%%%%%    .....    %%%%%%
%%%%                                 %%%%%%%   .......   %%%%%%
%%%%                                 %%%%%%%   .......   %%%%%%
%%%%                                 %%%%%%%   .......   %%%%%%
%%%%                                 %%%%%%%    .....    %%%%%%
%%%%                                 %%%%%%%%%%%%%%%%%%%%%%%%%%
%%%%                                 %%%%%%%%%%%%%%%%%%%%%%%%%%
%%%%                                 %%%%%%%%%%%%%%%%%%%%%%%%%%
%%%%                                 %%%%%%%%%%%%%%%%%%%%%%%%%%
%%%%%%%%%%%%%%%%%%%%%%%%%%%%%%%%%%%%%%%%%%%%%%%%%%%%%%%%%%%%%%%
%%%%%%%%%%%%%%%%%%%%%%%%%%%%%%%%%%%%%%%%%%%%%%%%%%%%%%%%%%%%%%%
%%%%%%%%%%%%%%%%%%%%%%%%%%%%%%%%%%%%%%%%%%%%%%%%%%%%%%%%%%%%%%%
%%%%%%%%%%%%%%%%%%%%%%%%%%%%%%%%%%%%%%%%%%%%%%%%%%%%%%%%%%%%%%%
#
%%%%%%%%%%%%%%%%%%%%%%%%%%%%%%%%%%%%%%%%%%%%%%%%%%%%%%%%%%%%%%%
%%%%%%%%%%%%%%%%%%%%%%%%%%%%%%%%%%%%%%%%%%%%%%%%%%%%%%%%%%%%%%%
%%%%%%%%%%%%%%%%%%%%%%%%%%%%%%%%%%%%%%%%%%%%%%%%%%%%%%%%%%%%%%%
%%%%%%%%%%%%%%%%%%%%%%%%%%%%%%%%%%%%%%%%%%%%%%%%%%%%%%%%%%%%%%%
%%%%%%%%%%%%%%%%%%%%%%%%%%%%%%%%%%%%%%%%%%%%%%%%%%%%%%%%%%%%%%%
%%%%%%%%%%%%%%%%%%%%%%%%%%%%%%%%%%%%%%%%%%%%%%%%%%%%%%%%%%%%%%%
%% %%%%%%%%%%%%%%%%%%%%%%%%%%%%%%%%%%%%%%%%%%%%%%   %       %%%
%% %%%%%%%%%%%%%%%%%%%%%%%%%%%%%%%%%%%%%%%%%%%%%%%  %       %%%
%% %%%    %         %%%%%%%%%%%%%%%%%%%%%%%%%%%%%%  %       %%%
%% %%%%%%%%%%%%%%%%%%%%%%%%%%%%%%%%%%%%%%%%%%%%%%%  %       %%%
%% %%%%%%%%%%%%%%%%%%%%%%%%%%%%%%%%%%%  %  %%%%%%%% %       %%%
%% %%%%%%%%%%%%%%%%%%%%%%%%%%%%%%%%%%%% %   %%%%%%% %       %%%
%% %%%%%%%%%%%%%%%%%%%%%%%%%%%%%%%%%%%% %   %%%%%%%%%       %%%
%% %%%%%%%%%%%%%%%%%%%%%%%%%%%%%%%%%%%%%%    %%%%%%%%       %%%
%% %%%%%%%%%%%%%%%%%%%%%%%%%%%%%%%%%%%%%%    %%%%%%%%       %%%
%% %%%%%%%%%%%%%%%%%%%%%%%%%%%%%%%%%%%%%%     %%%%%%%       %%%
%% %%%%%%%%%%%%%%%%%%%%%%%%%%%%%%%%%%%%%%     %%%%%%%%      %%%
%% %%%%%%%%%%%%%%%%%%%%%%%%%%%%%%%%%%%%%%%     %%%%%%%      %%%
%% %%%%%%%%%%%%%%%%%%%%%%%%%%%%%%%%%%%%%%%     %%%%%%%      %%%
%% %%%%%%%%%%%%%%%%%%%%%%%%%%%%%%%%%%%%%%%     %%%%%%%      %%%
%%  %    %%%%%%%%%%%%%%%%%%%%%%%%%%%%%%%%%     %%%%%%%      %%%
%%  %    %%%%%%%%%%%%%%%%%%%%%%%%%%%%%%%%%     %%%%%%%      %%%
%%  %    %%%%%%%%%%%%%%%%%%%%%%%%%%%%%%%%%     % %%%%%      %%%
%%  %    %%%%%%%%%%%%%%%%%%%%%%%%%%%%%%%%%     % %%%%%      %%%
%%  %    %%%%%%%%%%%%%%%%%%%%%%%%%%%%%%%%%     %%%%%%%      %%%
%%  %    %%%%%%%%%%%%%%%%%%%%%%%%%%%%%%%%%     %%%%%%%      %%%
%%  %    %%%%%%%%%%%%%%%%%%%%%%%%%%%%%%%%%     %%%%%%%      %%%
%%  %    %%%%%%%%%%%%%%%%%%%%%%%%%%%%%%%%%    %%%%%%%%      %%%
%%  %    %%%%%%%%%%%%%%%%%%%%%%%%%%%%%%%%%    %%%%%%%%      %%%
%%  %    %%%%%%%%%%%%%%%%%%%%%%%%%%%%%%%%%    %%%%%%%%      %%%
%%  %     %   %%%%%%%%%%%%%%%%%%%%%%%%%%%%    %%%%%%%%      %%%
%%  %     %  %%%%%%%%%%%%%%%%%%%%%%%%%%%%%    %%%%%%%%      %%%
%%  %     % %%%%%%%%%%%%%%%%%%%%%%%%%%%%%%    %%%%%%%       %%%
%%  %     %%%%%%%%%%%%%%%%%%%%%%%%%%%%%%%%    %%%%%%%       %%%
%%  %     %%%%%%%%%%%%%%%%%%%%%%%%%%%%%%%%    %%%%%%%       %%%
%%  %    %%%%%%%%%%%%%%%%%%%%%%%%%%%%%%%%%    %%%%% %       %%%
%%  %    %%%%%%%%%%%%%%%%%%%%%%%%%%%%%%%%%    %%%%  %       %%%
%%  %    %%%%%%%%%%%%%%%%%%%%%%%%%%%%%%%%%    %%%   %       %%%
%%  %    %%%%%%%%%%%%%%%%%%%%%%%%%%%%%%%%%    %%%   %       %%%
%%  %    %%%%%%%%%%%%%%%%%%%%%%%%%%%%%%%%%    %%%%%%%%%%%%%%%%%
%%  %    %%%%%%%%%%%%%%%%%%%%%%%%%%%%%%%%%    %%%%%%%%%%%%%%%%%
%%  %    %%%%%%%%%%%%%%%%%%%%%%%%%%%%%%%%%    %%%%%%%%%%%%%%%%%
%%  %    %%%%%%%%%%%%%%%%%%%%%%%%%%%%%%%%%    %%%%%%%%%%%%%%%%%
%%  %    %%%%%%%%%%%%%%%%%%%%%%%%%%%%%%%%%    %%%%%%%%%%%%%%%%%
%%  %    %%%%%%%%%%%%%%%%%%%%%%%%%%%%%%%%%    %%%%%%%%%%%%%%%%%
%%  %    %%%%%%%%%%%%%%%%%%%%%%%%%%%%%%%%%    %%%%%%%%%%%%%%%%%
%%  %     %         %                  %%%    %%%%%%%%%%%%%%%%%
%%  %     %         %                  %%%    %%%%%%%%%%%%%%%%%
%%  %     %         %                  %%%    %%%%%%%%%%%%%%%%%
%%  %     %         %                  %%%    %%%%%%%%%%%%%%%%%
%%  %     %         %                  %%%     %....%      %%%%
%%  %     %         %                  %%%%%%%%%%%%%%%%%%%%%%%%
%%  %     %         %                  %%%%%%%%%%%%%%%%%%%%%%%%
%%  %     %         %                  %%%%%%%%%%%%%%%%%%%%%%%%
%%  %     %         %                  %%%%%%%%%%%%%%%%%%%%%%%%
%%%%%%%%%%%%%%%%%%%%%%%%%%%%%%%%%%%%%%%%%%%%%%%%%%%%%%%%%%%%%%%
%%%%%%%%%%%%%%%%%%%%%%%%%%%%%%%%%%%%%%%%%%%%%%%%%%%%%%%%%%%%%%%
%%%%%%%%%%%%%%%%%%%%%%%%%%%%%%%%%%%%%%%%%%%%%%%%%%%%%%%%%%%%%%%
%%%%%%%%%%%%%%%%%%%%%%%%%%%%%%%%%%%%%%%%%%%%%%%%%%%%%%%%%%%%%%%
%%%%%%%%%%%%%%%%%%%%%%%%%%%%%%%%%%%%%%%%%%%%%%%%%%%%%%%%%%%%%%%
%%%%%%%%%%%%%%%%%%%%%%%%%%%%%%%%%%%%%%%%%%%%%%%%%%%%%%%%%%%%%%%
#
